   AVP32 Scan  26/06/2000  21:53:28

c:\windows\bureau\d\mes virus & worms en cours\matrix zine  #1 & #2\pif worm tut final\del_ pif total tutorial\pifworms\worm files\EmmaPeel.HTML.pif	infected: IRC-Worm.Elsa.b
c:\windows\bureau\d\mes virus & worms en cours\matrix zine  #1 & #2\pif worm tut final\del_ pif total tutorial\pifworms\worm files\cuteELSA.JPG.pif	infected: IRC-Worm.Elsa
c:\windows\bureau\d\mes virus & worms en cours\matrix zine  #1 & #2\pif worm tut final\del_ pif total tutorial\pifworms\worm files\X_PASS.TXT.pif	infected: IRC-Worm.Movie.c  << !!! GRRRRRRR !!!!!!

Scan process complete.

Scanned

Sector Objects :         0
Files :	                 6
Folders :	         1
Archives :	         0
Packed :	         0

Found

Known viruses :	         3
Virus bodies :	         3
Disinfected :	         0
Deleted :	         0
Warnings :	         0
Suspicious :	         0
Corrupted :	         0
Cannot Access :	         0

Scan speed (Kb/sec) :    3
Scan time :	     00:01
